20 20
5 5 5 5 5 5 5 5 5 5 5 5 5 5 5 5 5 5 5 5
5 11 11 5 2 2 2 2 2 2 5 2 2 2 2 5 2 2 2 5
5 2 2 2 2 2 2 2 2 2 2 2 2 2 2 2 2 2 2 5
5 2 2 2 2 2 5 5 2 2 2 2 2 2 2 2 2 2 2 5
5 2 2 2 2 5 5 5 5 5 2 2 5 2 5 2 2 5 5 5
5 5 5 5 5 5 7 7 7 5 5 5 5 2 5 5 5 5 5 5
5 5 5 5 5 5 1 1 1 5 5 5 5 2 5 5 5 5 5 5
5 5 5 5 5 5 1 1 1 5 5 5 5 2 5 5 5 5 5 5
0 1 1 1 1 1 1 1 1 1 1 1 1 1 1 1 1 1 5 5
0 1 1 1 1 1 1 1 1 1 1 1 1 1 1 1 1 1 1 1
0 1 1 1 1 1 1 1 1 1 1 1 1 1 1 1 1 1 1 1
0 1 1 1 1 1 1 1 1 1 1 1 1 1 1 1 1 1 1 5
0 1 1 1 1 1 1 1 1 1 1 1 1 1 1 1 1 1 1 5
0 1 1 1 1 1 1 1 1 1 1 1 1 1 1 1 1 1 1 5
0 1 1 1 1 1 1 1 1 1 1 1 1 1 1 1 1 1 1 5
0 1 1 1 1 1 1 1 1 1 1 1 1 1 1 1 1 1 1 0
0 1 1 1 1 1 1 1 1 1 1 1 1 1 1 1 1 1 1 0
0 1 1 1 1 1 1 1 1 1 1 1 1 1 1 1 1 1 1 0
0 1 1 1 1 1 1 1 1 1 1 1 1 1 1 1 1 1 1 0
0 1 1 1 1 1 1 1 1 1 1 1 1 1 1 1 1 1 1 0