20 20
5 5 5 5 5 5 5 5 5 5 2 2 2 5 5 5 5 5 5 5
5 5 5 5 5 5 5 5 5 5 2 2 2 5 5 5 5 5 5 5
5 5 2 2 2 2 2 2 2 2 2 2 2 2 2 2 2 2 2 5
5 5 2 2 2 2 2 2 2 2 2 2 2 2 2 2 2 2 2 5
5 5 5 2 2 2 2 2 2 2 2 2 2 2 2 2 2 2 2 5
5 5 5 2 2 0 0 0 0 0 0 0 0 0 0 0 2 2 2 5
5 5 5 2 2 0 0 0 0 0 0 0 0 0 0 0 2 2 2 5
5 5 5 2 2 0 0 0 2 2 2 2 2 2 0 0 2 2 2 5
5 5 2 2 2 0 0 0 2 2 2 2 2 2 0 0 2 2 2 5
2 2 2 2 2 2 2 2 2 2 2 2 2 2 2 2 2 2 2 5
2 2 2 2 2 2 2 2 2 2 2 2 2 2 2 2 2 2 2 5
5 5 2 2 2 0 0 0 2 2 2 2 2 2 0 0 2 2 2 2
5 5 2 2 2 0 0 0 2 2 2 2 2 2 0 0 2 2 2 2
5 5 2 2 2 0 0 0 0 0 0 0 0 0 0 0 2 2 2 5
5 5 2 2 2 0 0 0 0 0 0 0 0 0 0 0 2 2 2 5
0 5 5 2 2 2 2 2 2 2 2 2 2 2 2 2 2 2 2 5
0 0 5 2 2 2 2 2 2 2 2 2 2 2 2 2 2 2 2 5
0 0 5 5 5 5 5 2 2 2 2 2 2 2 2 2 2 2 2 5
0 0 0 0 5 5 5 2 2 2 2 2 2 2 2 2 2 2 2 5
0 0 0 0 0 0 0 0 0 0 0 0 0 0 0 0 0 0 0 0